1,1,0,1,2,3,8,-1,3,1,2,5,9,10,-1,0
1,10,0,10,3,0,0,10,3,0,0,2,,,,
2,1,0,1,3,4,8,9,-1,8,0,1,6,5,-1,0
2,10,0,10,3,0,0,10,3,0,0,2,,,,
3,3,1,2,5,10,-1,8,0,1,4,6,8,11,-1,0
3,10,0,10,3,0,0,10,3,0,0,2,,,,
4,1,1,1,1,1,1,1,1,8,8,8,-1,1,-1,0
4,3,7,10,3,0,0,10,3,0,0,0,,,,
5,3,0,0,0,0,0,0,0,8,8,8,-1,3,-1,0
5,4,6,10,3,0,0,10,3,0,0,0,,,,
6,8,0,0,0,0,2,6,6,8,8,8,-1,8,-1,0
6,4,6,10,3,0,0,10,3,0,0,0,,,,
